abandon	negativ
abandonment	negativ
abate	negativ
abdicate	negativ
abhor	negativ
abide	positiv
ability	positiv
abject	negativ
able	positiv
abnormal	negativ
abolish	negativ
abominable	negativ
abound	positiv
abrasive	negativ
abrupt	negativ
abscond	negativ
absence	negativ
absent	negativ
absent-minded	negativ
absentee	negativ
absolve	positiv
absorbent	positiv
absorption	positiv
absurd	negativ
absurdity	negativ
abundance	positiv
abundant	positiv
abuse	negativ
abuse	negativ
abyss	negativ
accede	positiv
accentuate	positiv
accept	positiv
acceptable	positiv
acceptance	positiv
accessible	positiv
accession	positiv
accident	negativ
acclaim	positiv
acclamation	positiv
accolade	positiv
accommodate	positiv
accommodation	positiv
accompaniment	positiv
accomplish	positiv
accomplishment	positiv
accord	positiv
accord	positiv
accord	positiv
accordance	positiv
accost	negativ
accountable	positiv
accrue	positiv
accuracy	positiv
accurate	positiv
accurateness	positiv
accursed	negativ
accusation	negativ
accuse	negativ
accuse	negativ
ache	negativ
achieve	positiv
achievement	positiv
acknowledgement	positiv
acquaint	positiv
acquaintance	positiv
acquit	positiv
acquittal	positiv
acrimonious	negativ
acrimony	negativ
actual	positiv
actual	positiv
actuality	positiv
adamant	positiv
adaptability	positiv
adaptable	positiv
adaptation	positiv
adaptive	positiv
addict	negativ
addiction	negativ
adept	positiv
adeptness	positiv
adequate	positiv
adherence	positiv
adherent	positiv
adhesion	positiv
adhesive	positiv
adjunct	positiv
adjust	positiv
adjustable	positiv
adjustment	positiv
admirable	positiv
admiration	positiv
admire	positiv
admirer	positiv
admit	positiv
admit	positiv
admit	positiv
admittance	positiv
admonish	negativ
admonition	negativ
adorable	positiv
adore	positiv
adorn	positiv
adornment	positiv
adroit	positiv
adroitly	positiv
adulation	positiv
adult	positiv
adulterate	negativ
adulteration	negativ
adultery	negativ
advance	positiv
advance	positiv
advance	positiv
advancement	positiv
advantage	positiv
advantageous	positiv
advent	positiv
adventuresome	positiv
adventurous	positiv
adversary	negativ
adverse	negativ
adversity	negativ
advisable	positiv
advocacy	positiv
affability	positiv
affable	positiv
affectation	negativ
affection	positiv
affectionate	positiv
affiliate	positiv
affiliation	positiv
affinity	positiv
affirm	positiv
affirmation	positiv
affirmative	positiv
affix	positiv
afflict	negativ
affliction	negativ
affluence	positiv
affluent	positiv
afloat	positiv
afraid	negativ
against	negativ
aggravate	negativ
aggravation	negativ
aggregate	positiv
aggregation	positiv
aggression	negativ
aggressive	negativ
aggressiveness	negativ
aggressor	negativ
aggrieve	negativ
aghast	negativ
agile	positiv
agility	positiv
agitate	negativ
agitation	negativ
agitator	negativ
agonize	negativ
agony	negativ
agreeable	positiv
agreement	positiv
aid	positiv
aid	positiv
ail	negativ
ailment	negativ
aimless	negativ
alarm	negativ
alarming	negativ
alas	negativ
alertness	positiv
alibi	negativ
alien	negativ
alienate	negativ
alienation	negativ
alight	positiv
alive	positiv
allegation	negativ
allege	negativ
allegiance	positiv
alleviate	positiv
alliance	positiv
allied	positiv
allies	positiv
allow	positiv
allowable	positiv
allowance	positiv
allure	positiv
ally	positiv
almighty	positiv
aloof	negativ
altercation	negativ
altruistic	positiv
amazement	positiv
amazing	positiv
ambiguity	negativ
ambiguous	negativ
ambivalent	negativ
ambush	negativ
ambush	negativ
ameliorate	positiv
amenable	positiv
amenity	positiv
amiability	positiv
amiable	positiv
amicable	positiv
amiss	negativ
amnesty	positiv
amour	positiv
ample	positiv
amplify	positiv
amply	positiv
amputate	negativ
amuse	positiv
amusement	positiv
anarchist	negativ
anarchy	negativ
angel	positiv
angelic	positiv
anger	negativ
anger	negativ
angry	negativ
anguish	negativ
animosity	negativ
annihilate	negativ
annihilation	negativ
annoy	negativ
annoyance	negativ
anoint	positiv
anomalous	negativ
anomaly	negativ
antagonism	negativ
antagonist	negativ
antagonistic	negativ
antagonize	negativ
anti-social	negativ
antipathy	negativ
antiquated	negativ
antitrust	negativ
anxiety	negativ
anxious	negativ
anxious	negativ
anxiousness	negativ
apathetic	negativ
apathy	negativ
apocalypse	positiv
appall	negativ
appall	negativ
appeal	positiv
appease	positiv
append	positiv
applaud	positiv
applause	positiv
appoint	positiv
appoint	positiv
appreciable	positiv
appreciate	positiv
appreciation	positiv
appreciative	positiv
apprehend	positiv
apprehension	negativ
apprehensive	negativ
approach	positiv
approach	positiv
appropriate	positiv
approval	positiv
approve	positiv
approve	positiv
apt	positiv
aptitude	positiv
arbiter	positiv
arbitrary	negativ
arbitrate	positiv
arbitration	positiv
ardent	positiv
arduous	negativ
argue	negativ
argument	negativ
arisen	positiv
aristocracy	positiv
aristocrat	positiv
aristocratic	positiv
arrest	negativ
arrest	negativ
arrest	positiv
arrogance	negativ
arrogant	negativ
art	positiv
art	positiv
artificial	negativ
ascribe	positiv
ashamed	negativ
aspiration	positiv
aspire	positiv
assail	negativ
assailant	negativ
assassin	negativ
assassinate	negativ
assault	negativ
assault	negativ
assent	positiv
assertion	positiv
asset	positiv
assist	positiv
assist	positiv
assistance	positiv
assistant	positiv
associate	positiv
associate	positiv
associate	positiv
association	positiv
association	positiv
assurance	positiv
assure	positiv
assure	positiv
assure	positiv
assuredly	positiv
astound	positiv
astray	negativ
astute	positiv
asunder	negativ
athletic	positiv
atrocious	negativ
atrophy	negativ
attachment	positiv
attack	negativ
attack	negativ
attack	negativ
attain	positiv
attainment	positiv
attend	positiv
attendance	positiv
attentive	positiv
attract	positiv
attraction	positiv
attractive	positiv
attractiveness	positiv
attune	positiv
audacious	negativ
audacity	negativ
audible	positiv
augment	positiv
augmentation	positiv
auspicious	positiv
austere	negativ
authentic	positiv
authenticity	positiv
authoritative	positiv
authority	positiv
autocrat	negativ
autocratic	negativ
autonomous	positiv
availability	positiv
avarice	negativ
avaricious	negativ
avenge	negativ
aversion	negativ
avert	negativ
avid	positiv
avoid	negativ
avoidance	negativ
award	positiv
award	positiv
aware	positiv
awareness	positiv
awful	negativ
awkward	negativ
awkwardness	negativ
ax	negativ
babble	negativ
back	positiv
back	positiv
backbone	positiv
backer	positiv
backing	positiv
backward	negativ
backwardness	negativ
bad	negativ
badly	negativ
baffle	negativ
bafflement	negativ
bail	negativ
bait	negativ
balk	negativ
ball	positiv
ball	positiv
balmy	positiv
banal	negativ
bandit	negativ
bane	negativ
banish	negativ
banish	negativ
banishment	negativ
bankrupt	negativ
bankruptcy	negativ
baptism	positiv
baptize	positiv
bar	negativ
barbarian	negativ
barbarous	negativ
bargain	positiv
barren	negativ
barrier	negativ
bashful	negativ
basic	positiv
basic	positiv
bastard	negativ
battle	negativ
battle	negativ
battlefield	negativ
beacon	positiv
beastly	negativ
beat	negativ
beat	negativ
beat	negativ
beauteous	positiv
beautify	positiv
beauty	positiv
befit	positiv
befitting	positiv
befriend	positiv
beg	negativ
beggar	negativ
behalf	positiv
behead	negativ
belated	negativ
belie	negativ
belittle	negativ
belligerent	negativ
beloved	positiv
belt	negativ
benefactor	positiv
beneficent	positiv
beneficial	positiv
beneficiary	positiv
benefit	positiv
benefit	positiv
benefit	positiv
benevolence	positiv
benevolent	positiv
benign	positiv
bequeath	positiv
bereave	negativ
bereavement	negativ
bereft	negativ
berserk	negativ
beseech	negativ
beset	negativ
besiege	negativ
best	positiv
bestow	positiv
betray	negativ
betrayal	negativ
betroth	positiv
betrothal	positiv
better	positiv
better	positiv
beware	negativ
bewilder	negativ
bewilderment	negativ
bit	negativ
bitchy	negativ
bite	negativ
bite	negativ
bite	negativ
bitter	negativ
bitterness	negativ
bizarre	negativ
blackmail	negativ
blah	negativ
blame	negativ
blame	negativ
blameless	positiv
bland	negativ
blast	negativ
blast	negativ
blatant	negativ
bleak	negativ
blemish	negativ
bless	positiv
bless	positiv
bless	positiv
blind	negativ
blind	negativ
blind	negativ
blind	negativ
blindness	negativ
bliss	positiv
blissful	positiv
blithe	positiv
block	negativ
block	negativ
blockhead	negativ
bloodshed	negativ
bloodthirsty	negativ
bloody	negativ
bloom	positiv
blossom	positiv
blow	negativ
blow	negativ
blunder	negativ
blunt	negativ
blur	negativ
blurt	negativ
board	negativ
board	positiv
boast	negativ
boastful	negativ
bogus	negativ
boisterous	negativ
boldness	positiv
bolster	positiv
bolt	negativ
bomb	negativ
bomb	negativ
bombard	negativ
bombardment	negativ
bondage	negativ
bonny	positiv
bonus	positiv
boom	positiv
boost	positiv
boost	positiv
boot	negativ
bore	negativ
bore	negativ
bore	negativ
boredom	negativ
bother	negativ
bother	negativ
bothersome	negativ
bound	negativ
boundless	positiv
bountiful	positiv
bout	negativ
box	negativ
brag	negativ
brainy	positiv
brandish	negativ
brat	negativ
bravado	negativ
brave	positiv
bravery	positiv
brawl	negativ
brazen	negativ
breach	negativ
breadwinner	positiv
break	negativ
break	negativ
break	negativ
breakdown	negativ
bribe	negativ
bright	positiv
brightness	positiv
brilliance	positiv
brilliant	positiv
bristle	negativ
brittle	negativ
broke	negativ
broke	negativ
broke	negativ
broke	negativ
broken-hearted	negativ
brood	negativ
brotherhood	positiv
brotherly	positiv
bruise	negativ
brusque	negativ
brutality	negativ
brute	negativ
brutish	negativ
buckle	negativ
bug	negativ
bullet	negativ
bum	negativ
bungle	negativ
buoyant	positiv
burden	negativ
burden	negativ
burdensome	negativ
burglar	negativ
burglary	negativ
burn	negativ
burn	negativ
burn	negativ
burn	negativ
bury	negativ
busybody	negativ
butchery	negativ
buy	positiv
calamity	negativ
call	positiv
callous	negativ
calm	positiv
calm	positiv
calm	positiv
calmness	positiv
cancel	negativ
cancellation	negativ
cancer	negativ
candid	positiv
candor	positiv
cannibal	negativ
cannon	negativ
capability	positiv
capable	positiv
capital	negativ
capitalize	positiv
capitulate	negativ
capricious	negativ
capsize	negativ
captivation	positiv
captive	negativ
capture	negativ
capture	negativ
care	positiv
care	positiv
careen	negativ
carefree	positiv
careful	positiv
careless	negativ
carelessness	negativ
caress	positiv
caress	positiv
casual	positiv
casualty	negativ
cataclysm	negativ
catastrophe	negativ
catch	negativ
cave	negativ
ceaseless	positiv
celebrate	positiv
celebration	positiv
celebrity	positiv
censor	negativ
censorship	negativ
censure	negativ
ceremonial	positiv
chafe	negativ
challenge	negativ
challenge	negativ
champ	positiv
champion	positiv
championship	positiv
chaos	negativ
chaotic	negativ
charge	negativ
charge	negativ
charge	negativ
charge	negativ
charisma	positiv
charitable	positiv
charity	positiv
charm	positiv
charm	positiv
chase	negativ
chase	negativ
chaste	positiv
chastise	negativ
cheap	negativ
cheapen	negativ
cheater	negativ
cheer	positiv
cheerful	positiv
cheery	positiv
cherish	positiv
cherish	positiv
cherub	positiv
chic	positiv
chide	negativ
childish	negativ
chivalrous	positiv
chivalry	positiv
choke	negativ
choke	negativ
chore	negativ
chosen	positiv
chronic	negativ
chum	positiv
circle	negativ
civil	positiv
civility	positiv
civilization	positiv
civilize	positiv
civilize	positiv
clamor	negativ
clamorous	negativ
clarify	positiv
clarity	positiv
clash	negativ
classic	positiv
clatter	negativ
clean	positiv
clean	positiv
cleanliness	positiv
cleanse	positiv
clear	positiv
clear	positiv
clear	positiv
clear	positiv
clear	positiv
clearness	positiv
clever	positiv
clique	negativ
clog	negativ
close	negativ
close	negativ
closeness	positiv
clout	positiv
club	negativ
club	negativ
clumsy	negativ
clutter	negativ
co-operation	positiv
coarse	negativ
coarseness	negativ
coax	positiv
cockiness	negativ
cocky	negativ
coddle	positiv
coerce	negativ
coercion	negativ
coercive	negativ
coexistence	positiv
cogent	positiv
cognizance	positiv
cognizant	positiv
coherent	positiv
cohesion	positiv
cohort	positiv
coincident	positiv
cold	negativ
cold	negativ
cold	negativ
cold	negativ
collaborate	positiv
collaboration	positiv
collapse	negativ
collapse	negativ
colleague	positiv
collide	negativ
collision	negativ
collusion	negativ
colony	negativ
colossal	positiv
combat	negativ
combat	negativ
combatant	negativ
comeback	positiv
comedy	positiv
comely	positiv
comestible	positiv
comfort	positiv
comfort	positiv
comfort	positiv
comfortable	positiv
comic	positiv
comical	positiv
commemorate	positiv
commemoration	positiv
commencement	positiv
commend	positiv
commendable	positiv
commendation	positiv
commensurate	positiv
commiseration	negativ
commission	positiv
commit	negativ
commitment	positiv
commodious	positiv
common	positiv
common	positiv
commoner	negativ
commonplace	negativ
commonsense	positiv
commotion	negativ
communal	positiv
commune	positiv
communicate	positiv
communicate	positiv
communicative	positiv
communion	positiv
community	positiv
companion	positiv
companionship	positiv
company	positiv
compassion	positiv
compassionate	positiv
compatible	positiv
compel	negativ
compel	negativ
compensate	positiv
compensation	positiv
compete	negativ
competence	positiv
competency	positiv
competent	positiv
competition	negativ
competitive	negativ
competitor	negativ
complain	negativ
complaint	negativ
complement	positiv
complement	positiv
complementary	positiv
complete	positiv
complete	positiv
completeness	positiv
completion	positiv
complex	negativ
complexity	negativ
compliance	positiv
complicate	negativ
complicate	negativ
complication	negativ
complicity	negativ
compliment	positiv
composure	positiv
comprehend	positiv
comprehension	positiv
comprehensive	positiv
compromise	positiv
compromise	positiv
compulsion	negativ
conceal	negativ
conceit	negativ
concern	negativ
concern	negativ
concession	positiv
conclusive	positiv
concur	positiv
condemn	negativ
condemn	negativ
condemnation	negativ
condescending	negativ
condescension	negativ
condone	positiv
conducive	positiv
confederation	positiv
confer	positiv
confess	negativ
confession	negativ
confidant	positiv
confide	positiv
confidence	positiv
confident	positiv
confine	negativ
confine	negativ
confinement	negativ
confiscate	negativ
confiscation	negativ
conflict	negativ
conflict	negativ
conflict	negativ
conflict	negativ
confound	negativ
confront	negativ
confrontation	negativ
confuse	negativ
confuse	negativ
confuse	negativ
confuse	negativ
confusion	negativ
congenial	positiv
congested	negativ
congestion	negativ
congratulate	positiv
congratulation	positiv
congratulatory	positiv
congregate	positiv
conjunction	positiv
conjure	positiv
connect	positiv
conquer	positiv
conqueror	positiv
conquest	positiv
conscience	positiv
conscientious	positiv
consensus	positiv
consent	positiv
consent	positiv
conserve	positiv
consider	positiv
consider	positiv
considerate	positiv
consideration	positiv
consign	positiv
consistency	positiv
consistent	positiv
console	positiv
consolidate	positiv
conspiracy	negativ
conspirator	negativ
conspire	negativ
constancy	positiv
consternation	negativ
constrain	negativ
constraint	negativ
constructive	positiv
consult	positiv
consultation	positiv
consummate	positiv
consumptive	negativ
contact	positiv
contact	positiv
contagious	negativ
contaminate	negativ
contamination	negativ
contempt	negativ
contemptible	negativ
contemptuous	negativ
contend	negativ
content	positiv
content	positiv
content	positiv
contentment	positiv
continuity	positiv
contradict	negativ
contradiction	negativ
contradictory	negativ
contrary	negativ
contribute	positiv
contribute	positiv
contribution	positiv
contributor	positiv
controversial	negativ
controversy	negativ
convene	positiv
convict	negativ
convict	negativ
conviction	positiv
convince	positiv
convince	positiv
cool	negativ
coolness	negativ
cooperate	positiv
cooperation	positiv
cooperative	positiv
cooperative	positiv
cooperative	positiv
coordinate	positiv
coordination	positiv
cordial	positiv
correct	positiv
correct	positiv
correct	positiv
correction	positiv
corrode	negativ
corrosion	negativ
corrosive	negativ
corrupt	negativ
corruption	negativ
cost	negativ
cost	negativ
costliness	negativ
costly	negativ
council	positiv
counsel	positiv
counsel	positiv
counteract	negativ
counteraction	negativ
counterfeit	negativ
courage	positiv
courageous	positiv
courteous	positiv
courtesy	positiv
courtly	positiv
covenant	positiv
covert	negativ
covet	negativ
coward	negativ
cozy	positiv
crafty	negativ
cram	negativ
cramp	negativ
cranky	negativ
crass	negativ
crave	negativ
crawl	negativ
craze	negativ
craziness	negativ
crazy	negativ
create	positiv
creative	positiv
creativity	positiv
credentials	positiv
credibility	positiv
credible	positiv
credit	positiv
credit	positiv
credulous	negativ
crime	negativ
criminal	negativ
cringe	negativ
cripple	negativ
crisis	negativ
critic	negativ
criticize	negativ
croak	negativ
crook	negativ
crooked	negativ
cross	negativ
cross	negativ
cross	negativ
crude	negativ
cruel	negativ
cruelty	negativ
crumble	negativ
crumple	negativ
crusade	positiv
crusader	positiv
crush	negativ
crush	negativ
crushing	negativ
cuddle	positiv
culminate	positiv
culmination	positiv
culpable	negativ
culprit	negativ
cultivate	positiv
cultivate	positiv
cultivation	positiv
culture	positiv
cumbersome	negativ
cupid	positiv
cure	positiv
cure	positiv
curse	negativ
curse	negativ
cursory	negativ
curt	negativ
curtail	negativ
curtsey	positiv
cut	negativ
cut	negativ
cute	positiv
cynical	negativ
cynicism	negativ
damage	negativ
damage	negativ
damn	negativ
damnable	negativ
damned	negativ
dance	positiv
dance	positiv
dance	positiv
danger	negativ
dangerous	negativ
dare	positiv
daring	positiv
dark	negativ
darken	negativ
darkness	negativ
darling	positiv
darn	negativ
daunting	negativ
dauntless	positiv
dawdle	negativ
dawn	positiv
daze	negativ
dazzle	positiv
dead	negativ
deadlock	negativ
deadly	negativ
deadweight	negativ
deaf	negativ
deafness	negativ
deal	positiv
deal	negativ
dear	positiv
dear	positiv
dearth	negativ
death	negativ
debatable	negativ
debtor	negativ
decadence	negativ
decadent	negativ
decay	negativ
decay	negativ
decease	negativ
deceit	negativ
deceitful	negativ
deceive	negativ
deceive	negativ
decency	positiv
decent	positiv
deception	negativ
deceptive	negativ
decipher	positiv
decline	negativ
decline	negativ
decompose	negativ
decorate	positiv
decoration	positiv
decorative	positiv
decrease	negativ
decrease	negativ
dedicate	positiv
dedicate	positiv
dedication	positiv
deduce	positiv
defame	negativ
default	negativ
defeat	negativ
defeat	negativ
defect	negativ
defective	negativ
defend	positiv
defendant	negativ
defender	positiv
defense	positiv
defensive	negativ
deference	positiv
defiance	negativ
defiant	negativ
deficiency	negativ
deficient	negativ
deficit	negativ
defile	negativ
definitive	positiv
defy	negativ
degenerate	negativ
degrade	negativ
dejected	negativ
delay	negativ
delay	negativ
delicacy	positiv
delicate	positiv
delight	positiv
delight	positiv
delightful	positiv
delinquency	negativ
delinquent	negativ
delirium	negativ
deluge	negativ
delusion	negativ
demean	negativ
demise	negativ
demolish	negativ
demon	negativ
demoralize	negativ
denial	negativ
denounce	negativ
dent	negativ
deny	negativ
dependability	positiv
dependable	positiv
dependent	negativ
deplete	negativ
deplorable	negativ
deplore	negativ
depose	negativ
depraved	negativ
depreciate	negativ
depreciation	negativ
depress	negativ
depress	negativ
depress	negativ
depression	negativ
depression	negativ
deprive	negativ
deride	negativ
derision	negativ
derisive	negativ
derogatory	negativ
descry	positiv
desert	negativ
desert	negativ
desertion	negativ
deserve	positiv
deservedly	positiv
desirable	positiv
desire	negativ
desirous	positiv
desolate	negativ
desolation	negativ
despair	negativ
despair	negativ
desperate	negativ
desperation	negativ
despicable	negativ
despise	negativ
despise	negativ
destitute	negativ
destroy	negativ
destruction	negativ
destructive	negativ
detachment	negativ
detain	negativ
deter	negativ
deterrent	negativ
detest	negativ
detestable	negativ
detract	negativ
detrimental	negativ
devastate	negativ
devastation	negativ
deviate	negativ
deviation	negativ
devil	negativ
devilish	negativ
devious	negativ
devoid	negativ
devote	positiv
devote	positiv
devotion	positiv
devout	positiv
dexterity	positiv
diabolic	negativ
diabolical	negativ
dictate	negativ
dictatorial	negativ
differ	negativ
difficult	negativ
difficulty	negativ
dig	positiv
dignified	positiv
dignify	positiv
dignity	positiv
dilemma	negativ
diligent	positiv
dim	negativ
dim	negativ
din	negativ
dire	negativ
dirt	negativ
dirty	negativ
disable	negativ
disadvantage	negativ
disadvantageous	negativ
disagreeable	negativ
disagreement	negativ
disappoint	negativ
disappoint	negativ
disappoint	negativ
disappoint	negativ
disappointment	negativ
disapproval	negativ
disapprove	negativ
disarm	negativ
disaster	negativ
disastrous	negativ
disavow	negativ
disavowal	negativ
disbelief	negativ
discern	positiv
discharge	negativ
discharge	negativ
disclaim	negativ
discomfort	negativ
disconcerted	negativ
discontent	negativ
discord	negativ
discordant	negativ
discourage	negativ
discourage	negativ
discouragement	negativ
discredit	negativ
discreet	positiv
discrepant	negativ
discretion	positiv
discriminate	negativ
discuss	positiv
disdain	negativ
disease	negativ
diseased	negativ
disgrace	negativ
disguise	negativ
disgust	negativ
disgust	negativ
disgust	negativ
disgust	negativ
disgust	negativ
dishearten	negativ
dishonest	negativ
dishonor	negativ
disingenuous	negativ
disinterest	negativ
dislike	negativ
dislike	negativ
dismal	negativ
dismiss	negativ
dismiss	negativ
disobedience	negativ
disobedient	negativ
disorder	negativ
disorganized	negativ
dispel	negativ
dispensability	negativ
dispense	negativ
displace	negativ
displease	negativ
displeasure	negativ
disposal	negativ
dispose	negativ
dispose	negativ
disproportionate	negativ
disprove	negativ
disputable	negativ
dispute	negativ
dispute	negativ
disregard	negativ
disrupt	negativ
disruption	negativ
dissatisfaction	negativ
dissatisfied	negativ
dissatisfy	negativ
dissent	negativ
dissention	negativ
dissolution	negativ
distinct	positiv
distinction	positiv
distinctive	positiv
distinguish	positiv
distinguish	positiv
distinguished	positiv
distort	negativ
distortion	negativ
distract	negativ
distracting	negativ
distraction	negativ
distress	negativ
distress	negativ
distrustful	negativ
disturb	negativ
disturb	negativ
disturb	negativ
disturbance	negativ
diversion	negativ
divert	negativ
divide	negativ
divide	negativ
divine	positiv
divine	positiv
divinity	positiv
division	negativ
divorce	negativ
divorce	negativ
divorce	negativ
dizzy	negativ
doldrums	negativ
dominance	positiv
dominate	negativ
dominate	negativ
dominate	negativ
domination	negativ
donate	positiv
donation	positiv
doom	negativ
doom	negativ
doomsday	negativ
dope	negativ
dote	positiv
double	negativ
double	negativ
doubt	negativ
doubt	negativ
doubt	negativ
doubtful	negativ
doubtless	positiv
downcast	negativ
downfall	negativ
downhearted	negativ
drab	negativ
drag	negativ
dread	negativ
dreadful	negativ
dreamland	positiv
dreary	negativ
drive	negativ
droop	negativ
drop	negativ
drop	negativ
drop	negativ
drought	negativ
drown	negativ
drown	negativ
drowsiness	negativ
drowsy	negativ
drunk	negativ
drunk	negativ
drunkard	negativ
drunken	negativ
dubious	negativ
dull	negativ
dumb	negativ
dump	negativ
dump	negativ
dunce	negativ
dungeon	negativ
durability	positiv
durable	positiv
duty	negativ
dwindle	negativ
dying	negativ
dying	negativ
dynamic	positiv
eager	positiv
eagerness	positiv
earnest	positiv
earnestness	positiv
ease	positiv
ease	positiv
easy	positiv
easy	positiv
easy	positiv
easy	positiv
eccentric	negativ
eccentricity	negativ
economize	positiv
ecstasy	positiv
ecstatic	positiv
edge	negativ
edible	positiv
educated	positiv
education	positiv
educational	positiv
effective	positiv
effectiveness	positiv
efficacy	positiv
efficiency	positiv
efficient	positiv
egotistical	negativ
elaborate	positiv
elaboration	positiv
elate	positiv
elegance	positiv
elegant	positiv
eliminate	negativ
elimination	negativ
eloquent	positiv
embarrass	negativ
embarrassment	negativ
embellish	positiv
embrace	positiv
embrace	positiv
emergency	negativ
eminence	positiv
eminent	positiv
empathy	positiv
empower	positiv
empowerment	positiv
empty	negativ
empty	negativ
enable	positiv
enchant	positiv
enchant	positiv
enchantment	positiv
encourage	positiv
encourage	positiv
encouragement	positiv
encroach	negativ
encroachment	negativ
endanger	negativ
endear	positiv
endorse	positiv
endow	positiv
endurance	positiv
enemy	negativ
energetic	positiv
energize	positiv
enforce	negativ
engage	positiv
engulf	negativ
enhance	positiv
enhancement	positiv
enjoy	positiv
enjoyable	positiv
enjoyment	positiv
enlighten	positiv
enlighten	positiv
enlightenment	positiv
enrage	negativ
enrich	positiv
enrichment	positiv
ensemble	positiv
enslave	negativ
ensure	positiv
entangle	negativ
entanglement	negativ
entertain	positiv
entertain	positiv
entertainment	positiv
enthusiasm	positiv
enthusiastic	positiv
entreat	negativ
entrepreneurial	positiv
entrust	positiv
envious	negativ
envision	positiv
envy	negativ
epidemic	negativ
epithet	negativ
equality	positiv
equitable	positiv
equity	positiv
equivocal	negativ
eradicate	negativ
erase	negativ
erode	negativ
erosion	negativ
err	negativ
erroneous	negativ
error	negativ
esoteric	negativ
essential	positiv
essential	positiv
establish	positiv
establish	positiv
esteem	positiv
estranged	negativ
ethical	positiv
ethics	positiv
etiquette	positiv
evade	negativ
evasion	negativ
even	negativ
even	positiv
even	positiv
everlasting	positiv
evict	negativ
evil	negativ
evil	negativ
exact	positiv
exact	positiv
exaggeration	negativ
exalt	positiv
exasperate	negativ
exasperation	negativ
excel	positiv
excellence	positiv
excellent	positiv
exception	negativ
excess	negativ
excessive	negativ
excite	positiv
excite	positiv
excited	positiv
excitedness	positiv
excitement	positiv
exclude	negativ
exclusion	negativ
excommunication	negativ
execute	negativ
exempt	negativ
exertion	positiv
exhaust	negativ
exhaustion	negativ
exhilaration	positiv
exile	negativ
exit	negativ
exotic	positiv
expedient	negativ
expel	negativ
expense	negativ
expense	negativ
expensive	negativ
experience	positiv
experience	positiv
expert	positiv
expert	positiv
explode	negativ
exploit	negativ
explosion	negativ
explosive	negativ
expose	negativ
exquisite	positiv
exterminate	negativ
extermination	negativ
extinct	negativ
extinguish	negativ
extol	positiv
extraordinary	positiv
extravagance	positiv
extravagant	negativ
exuberance	positiv
exuberant	positiv
exult	positiv
exultation	positiv
eye	positiv
fabricate	negativ
fabrication	negativ
fabulous	positiv
facilitate	positiv
factual	positiv
fail	negativ
fail	negativ
fail	negativ
fail	negativ
failure	negativ
faint	negativ
fair	positiv
fair	positiv
fair	positiv
fairness	positiv
faith	positiv
faith	positiv
faithful	positiv
faithfulness	positiv
fake	negativ
fall	negativ
fallacy	negativ
fallout	negativ
false	negativ
falsehood	negativ
falter	negativ
fame	positiv
familiar	positiv
familiarity	positiv
familiarize	positiv
famine	negativ
famished	negativ
famous	positiv
fanatic	negativ
fanatical	negativ
fancy	positiv
fantastic	positiv
fantasy	positiv
farce	negativ
farsighted	positiv
fascination	positiv
fascist	negativ
fashionable	positiv
fat	negativ
fat	negativ
fat	negativ
fatal	negativ
fatalistic	negativ
fatigue	negativ
fault	negativ
favor	positiv
favor	positiv
favor	positiv
favor	positiv
favor	positiv
favorable	positiv
favorite	positiv
fear	negativ
fear	negativ
fear	negativ
fearful	negativ
fearless	positiv
fearsome	negativ
feasible	positiv
feast	positiv
feast	positiv
fed	negativ
feeble	negativ
feign	negativ
feint	negativ
fellow	positiv
fellowship	positiv
ferocious	negativ
ferocity	negativ
fertile	positiv
fervent	positiv
fervor	positiv
festival	positiv
festive	positiv
festivity	positiv
feud	negativ
feudal	negativ
fever	negativ
feverish	negativ
fiasco	negativ
fickle	negativ
fidelity	positiv
fidget	negativ
fiend	negativ
fierce	negativ
fiery	positiv
fight	negativ
fight	negativ
fight	negativ
fighter	negativ
filial	positiv
fill	positiv
filth	negativ
filthy	negativ
fine	positiv
fine	positiv
fine	positiv
fine	positiv
fine	positiv
fine	negativ
fine	negativ
fire	negativ
fire	negativ
fire	negativ
firmness	positiv
fist	negativ
fit	positiv
fit	positiv
fitness	positiv
fix	negativ
flagrant	negativ
flair	positiv
flashy	positiv
flatter	positiv
flattery	positiv
flaunt	positiv
flaw	negativ
flawless	positiv
fled	negativ
flee	negativ
fleeting	negativ
flexible	positiv
flimsy	negativ
flirt	positiv
floor	negativ
flounder	negativ
flourish	positiv
fluent	positiv
foe	negativ
foible	negativ
fond	positiv
fond	positiv
fond	positiv
fond	positiv
fond	positiv
fond	positiv
fond	positiv
fondness	positiv
fool	negativ
fool	negativ
foolish	negativ
foolishness	negativ
forbid	negativ
forbidden	negativ
force	negativ
force	negativ
force	negativ
foreboding	negativ
foreign	negativ
foremost	positiv
foresight	positiv
forfeit	negativ
forgave	positiv
forgetfulness	negativ
forgive	positiv
forgiven	positiv
forgiveness	positiv
forlorn	negativ
formality	positiv
formidable	negativ
forsake	negativ
fortify	positiv
fortitude	positiv
fortunate	positiv
forward	positiv
foster	positiv
fought	negativ
founder	negativ
fracture	negativ
fragile	negativ
fragrant	positiv
frank	positiv
frantic	negativ
frantically	negativ
fraud	negativ
fraudulent	negativ
fraught	negativ
freak	negativ
free	positiv
free	positiv
free	positiv
free	positiv
free	positiv
freedom	positiv
fresh	positiv
fret	negativ
fretful	negativ
friend	positiv
friendly	positiv
friendship	positiv
frighten	negativ
frighten	negativ
frighten	negativ
frightful	negativ
frigid	negativ
frivolous	negativ
frolic	positiv
front	negativ
frown	negativ
frown	negativ
frugal	positiv
fruitful	positiv
fruition	positiv
fruitless	negativ
frustrate	negativ
frustrate	negativ
frustrate	negativ
frustration	negativ
fugitive	negativ
fulfill	positiv
fulfillment	positiv
fullness	positiv
fumble	negativ
fun	positiv
fun	negativ
funny	positiv
funny	positiv
funny	positiv
furious	negativ
fury	negativ
fuss	negativ
fussy	negativ
futility	negativ
gaiety	positiv
gaily	positiv
gain	positiv
gain	positiv
gall	negativ
gallant	positiv
gallantry	positiv
gamble	negativ
gamble	negativ
game	positiv
garnish	positiv
gash	negativ
gaudy	negativ
gay	positiv
generate	positiv
generosity	positiv
generous	positiv
genial	positiv
genius	positiv
gentle	positiv
genuine	positiv
germ	negativ
get	negativ
ghastly	negativ
ghetto	negativ
giddy	positiv
gift	positiv
gifted	positiv
give	positiv
give	positiv
glad	positiv
glad	positiv
gladden	positiv
gladness	positiv
glamorous	positiv
glamour	positiv
glare	negativ
gleam	positiv
gleam	positiv
glean	positiv
glee	positiv
glimmer	positiv
glisten	positiv
glisten	positiv
glitter	positiv
glitter	positiv
gloat	negativ
gloom	negativ
gloomy	negativ
glorify	positiv
glorious	positiv
glory	positiv
glossy	positiv
glow	positiv
glow	positiv
glum	negativ
goddamn	negativ
godlike	positiv
godliness	positiv
gold	positiv
golden	positiv
good	positiv
goodbye	positiv
goodness	positiv
gorgeous	positiv
grab	negativ
grace	positiv
graceful	positiv
gracious	positiv
graduation	positiv
grand	positiv
grandeur	positiv
grapple	negativ
grateful	positiv
gratification	positiv
gratify	positiv
gratitude	positiv
gratuitous	negativ
grave	negativ
grave	negativ
grave	negativ
grave	negativ
grave	negativ
great	positiv
great	positiv
great	positiv
greatness	positiv
greet	positiv
greet	positiv
grief	negativ
grievance	negativ
grieve	negativ
grim	negativ
grizzly	negativ
groom	positiv
grotesque	negativ
growl	negativ
grudge	negativ
gruff	negativ
grumble	negativ
guarantee	positiv
guarantee	positiv
guardian	positiv
guerrilla	negativ
guide	positiv
guide	positiv
guide	positiv
guilt	negativ
guilty	negativ
guise	negativ
gullible	negativ
gun	negativ
gunmen	negativ
gusto	positiv
hack	negativ
hackney	negativ
hag	negativ
haggard	negativ
hallowed	positiv
hamper	negativ
hand	negativ
hand	positiv
handicap	negativ
handsome	positiv
handy	positiv
hang	negativ
hang	negativ
haphazard	negativ
hapless	negativ
happiness	positiv
happy	positiv
happy	positiv
happy	positiv
happy	positiv
harass	negativ
harassment	negativ
hard	negativ
hard	negativ
hardship	negativ
hardy	positiv
harm	negativ
harm	negativ
harmful	negativ
harmless	positiv
harmonious	positiv
harmonize	positiv
harmony	positiv
harness	positiv
harsh	negativ
hassle	negativ
hate	negativ
hate	negativ
hate	negativ
hater	negativ
hatred	negativ
haughty	negativ
haunt	negativ
haven	positiv
havoc	negativ
hazard	negativ
hazard	negativ
hazardous	negativ
haziness	negativ
hazy	negativ
headache	negativ
heal	positiv
health	positiv
healthful	positiv
healthy	positiv
healthy	positiv
healthy	positiv
heart	positiv
heartily	positiv
heartless	negativ
heaven	positiv
heavenly	positiv
hectic	negativ
hedge	negativ
hedonistic	negativ
heedless	negativ
heinous	negativ
hell	negativ
help	positiv
help	positiv
help	negativ
help	positiv
helpful	positiv
helpless	negativ
helplessness	negativ
hero	positiv
heroic	positiv
heroine	positiv
heroism	positiv
hideous	negativ
highlight	positiv
hilarious	positiv
hinder	negativ
hindrance	negativ
hit	negativ
hit	negativ
hit	positiv
hoard	negativ
hobble	negativ
hole	negativ
hole	negativ
hollow	negativ
holy	positiv
homage	positiv
home	positiv
homely	negativ
honest	positiv
honest	positiv
honest	positiv
honeymoon	positiv
honor	positiv
honor	positiv
honor	positiv
honorable	positiv
hope	positiv
hope	positiv
hopeful	positiv
hopeless	negativ
horde	negativ
horn	negativ
horrible	negativ
horrid	negativ
horrify	negativ
horror	negativ
hospitable	positiv
hostile	negativ
hostility	negativ
hot	negativ
hug	positiv
human	positiv
humanitarian	positiv
humanity	positiv
humble	positiv
humiliate	negativ
humiliation	negativ
humility	positiv
humor	positiv
humorous	positiv
hung	negativ
hunger	negativ
hungry	negativ
hunt	negativ
hunt	negativ
hunt	negativ
hunter	negativ
hurt	negativ
hurt	negativ
hurtful	negativ
hustle	negativ
hustler	negativ
hygiene	positiv
hypocrisy	negativ
hypocrite	negativ
hysteria	negativ
hysterical	negativ
ideal	positiv
ideal	positiv
ideal	positiv
idealism	positiv
idiot	negativ
idiotic	negativ
idleness	negativ
idol	positiv
idolize	positiv
ignoble	negativ
ignorance	negativ
ignorant	negativ
ill	negativ
ill	negativ
ill	negativ
ill	negativ
illegal	negativ
illegality	negativ
illiterate	negativ
illness	negativ
illogical	negativ
illuminate	positiv
illustrious	positiv
imagination	positiv
imaginative	positiv
immaculate	positiv
immature	negativ
immobility	negativ
immoral	negativ
immorality	negativ
immortal	positiv
immovable	negativ
impair	negativ
impartial	positiv
impartiality	positiv
impasse	negativ
impatience	negativ
impatient	negativ
impede	negativ
impediment	negativ
imperative	positiv
imperfect	negativ
impersonal	negativ
impervious	positiv
impetuous	negativ
impetus	positiv
implicate	negativ
implore	negativ
importance	positiv
important	positiv
impose	negativ
imprecision	negativ
impress	positiv
impressive	positiv
imprison	negativ
imprisonment	negativ
improper	negativ
improve	positiv
improve	positiv
improve	positiv
improvement	positiv
impulsive	negativ
impunity	positiv
impure	negativ
impurity	negativ
inability	negativ
inaccessible	negativ
inaccuracy	negativ
inadequate	negativ
inane	negativ
inaugurate	positiv
inauguration	positiv
incapable	negativ
incessant	negativ
incompatibility	negativ
incompatible	negativ
incompetence	negativ
incompetent	negativ
inconsistency	negativ
inconvenient	negativ
incorrect	negativ
incredible	negativ
incurable	negativ
indecent	negativ
indefinite	negativ
independence	positiv
independent	positiv
independent	positiv
indescribable	positiv
indeterminable	negativ
indeterminate	negativ
indicative	positiv
indictment	negativ
indifference	negativ
indifferent	negativ
indignation	negativ
indispensability	positiv
indispensable	positiv
individuality	positiv
indomitable	positiv
indulge	negativ
indulgence	positiv
industrious	positiv
ineffective	negativ
ineffectiveness	negativ
ineffectual	negativ
ineffectualness	negativ
inefficiency	negativ
inequality	negativ
inexact	negativ
inexpensive	positiv
inexplicable	negativ
infallibility	positiv
infallible	positiv
infamous	negativ
infect	negativ
infection	negativ
infer	positiv
inference	positiv
inferior	negativ
inferiority	negativ
infest	negativ
infiltration	negativ
inflame	negativ
inflation	negativ
inflict	negativ
inform	positiv
inform	positiv
infraction	negativ
infringement	negativ
infuriate	negativ
ingenious	positiv
ingenuity	positiv
ingratitude	negativ
inherit	positiv
inhibit	negativ
inhibition	negativ
inhumane	negativ
injunction	negativ
injure	negativ
injurious	negativ
injury	negativ
innocence	positiv
innocent	positiv
innovate	positiv
innovative	positiv
inquisitive	positiv
insane	negativ
insecure	negativ
insecurity	negativ
insensible	negativ
inseparable	positiv
insidious	negativ
insight	positiv
insignificant	negativ
insinuate	negativ
insistent	positiv
insolence	negativ
insolent	negativ
inspiration	positiv
inspirational	positiv
inspire	positiv
inspire	positiv
instability	negativ
instable	negativ
instinctive	positiv
insufficiency	negativ
insufficient	negativ
insult	negativ
integrity	positiv
intellect	positiv
intellectual	positiv
intellectual	positiv
intellectual	positiv
intelligence	positiv
intelligent	positiv
intelligible	positiv
intercede	positiv
intercourse	positiv
interest	positiv
interest	positiv
interest	positiv
interested	positiv
interested	positiv
interfere	negativ
interference	negativ
interpose	positiv
interrupt	negativ
interruption	negativ
intervention	negativ
intimacy	positiv
intimate	positiv
intimidate	negativ
intolerable	negativ
intoxicate	negativ
intricate	positiv
intrigue	positiv
intrude	negativ
intruder	negativ
intrusion	negativ
inundate	negativ
inundated	negativ
invade	negativ
invalid	negativ
invaluable	positiv
inventor	positiv
invincible	positiv
invisible	negativ
invitation	positiv
invite	positiv
invite	positiv
involuntary	negativ
involve	negativ
invulnerable	positiv
irk	negativ
iron	negativ
iron	negativ
ironic	negativ
irony	negativ
irrational	negativ
irregular	negativ
irregularity	negativ
irresistible	positiv
irresponsible	negativ
irritable	negativ
irritation	negativ
isolate	negativ
isolate	negativ
jail	negativ
jail	negativ
jar	negativ
jeer	negativ
jeopardize	negativ
jeopardy	negativ
jerk	negativ
jerk	negativ
jest	positiv
jittery	negativ
jobless	negativ
join	positiv
jointly	positiv
joke	positiv
joke	positiv
joke	positiv
jolly	positiv
joy	positiv
joyful	positiv
jubilant	positiv
jubilee	positiv
jumpy	negativ
junk	negativ
just	positiv
just	positiv
justice	positiv
justifiably	positiv
justification	positiv
justify	positiv
keen	positiv
kick	negativ
kick	negativ
kick	negativ
kid	positiv
kidnap	negativ
kill	negativ
kill	negativ
killer	negativ
kind	positiv
kind	positiv
kindness	positiv
kiss	positiv
kiss	positiv
knife	negativ
knock	negativ
knock	negativ
knock	negativ
know	positiv
know	positiv
knowledge	positiv
lack	negativ
lack	negativ
lack	negativ
lag	negativ
laid	negativ
lame	negativ
lament	negativ
lamentable	negativ
languish	negativ
lapse	negativ
laudable	positiv
laugh	positiv
laugh	positiv
laugh	negativ
laugh	positiv
laugh	positiv
laughter	positiv
lavish	positiv
law	positiv
lawful	positiv
lawless	negativ
lay	negativ
lazily	negativ
lazy	negativ
lead	positiv
leak	negativ
leakage	negativ
learn	positiv
learn	positiv
learner	positiv
legal	positiv
legitimacy	positiv
legitimate	positiv
leisure	positiv
let	negativ
liability	negativ
liable	negativ
liar	negativ
liberal	positiv
liberal	positiv
liberalism	positiv
liberate	positiv
liberty	positiv
lie	negativ
lie	negativ
lifeless	negativ
lifelong	positiv
light	positiv
light	positiv
likable	positiv
like	positiv
like	positiv
limit	negativ
limit	negativ
limit	negativ
limitation	negativ
limp	negativ
liquidate	negativ
liquidation	negativ
litter	negativ
live	positiv
lively	positiv
load	negativ
logic	positiv
logical	positiv
lone	negativ
loneliness	negativ
lonely	negativ
loner	negativ
lonesome	negativ
longevity	positiv
loom	negativ
lose	negativ
lose	negativ
loser	negativ
loss	negativ
lost	negativ
lost	negativ
lost	negativ
lost	negativ
love	positiv
love	positiv
love	positiv
love	positiv
loveless	negativ
loveliness	positiv
lovely	positiv
lover	positiv
lover	positiv
low	negativ
low	negativ
lower	negativ
lowly	negativ
loyal	positiv
loyalty	positiv
lucid	positiv
luck	positiv
luckily	positiv
lucky	positiv
lucrative	positiv
ludicrous	negativ
lull	negativ
luminous	positiv
lunatic	negativ
lure	negativ
lurk	negativ
lust	positiv
luster	positiv
lustrous	positiv
luxuriant	positiv
luxurious	positiv
luxury	positiv
lying	negativ
lying	negativ
lyric	positiv
lyrical	positiv
mad	negativ
mad	negativ
madman	negativ
madness	negativ
magical	positiv
magnetic	positiv
magnificence	positiv
magnificent	positiv
main	positiv
majestic	positiv
majesty	positiv
major	positiv
make	negativ
make	positiv
make	positiv
maladjusted	negativ
maladjustment	negativ
malady	negativ
malice	negativ
malicious	negativ
malignant	negativ
manageable	positiv
mangle	negativ
manipulate	negativ
manipulation	negativ
manly	positiv
manslaughter	negativ
mar	negativ
mar	negativ
marginal	negativ
marital	positiv
marriage	positiv
marry	positiv
marry	positiv
marvel	positiv
marvelous	positiv
massacre	negativ
masterful	positiv
mastery	positiv
matchless	positiv
mate	positiv
mate	positiv
matter	positiv
matter	negativ
mature	positiv
mature	positiv
mature	positiv
maturity	positiv
maximize	positiv
meager	negativ
mean	negativ
meaningful	positiv
meaningless	negativ
measurable	positiv
meddle	negativ
mediate	positiv
mediocre	negativ
meditation	positiv
meek	negativ
meet	positiv
melancholy	negativ
mellow	positiv
melodramatic	negativ
melody	positiv
memorable	positiv
menace	negativ
mend	positiv
menial	negativ
mentor	positiv
merciful	positiv
merciless	negativ
mercy	positiv
merit	positiv
merit	positiv
meritorious	positiv
merrily	positiv
merriment	positiv
merry	positiv
mesh	positiv
mess	negativ
mess	negativ
meticulous	positiv
mighty	positiv
mild	positiv
mind	negativ
mind	positiv
mindful	positiv
mine	negativ
minister	positiv
mint	positiv
miracle	positiv
miraculous	positiv
mirth	positiv
misbehave	negativ
misbehavior	negativ
mischief	negativ
mischievous	negativ
miser	negativ
miserable	negativ
misery	negativ
misfortune	negativ
mishandle	negativ
mishap	negativ
misinform	negativ
misinformed	negativ
mislead	negativ
misrepresent	negativ
miss	negativ
mistake	negativ
mistake	negativ
mistake	negativ
mistaken	negativ
mistrust	negativ
misunderstand	negativ
misunderstanding	negativ
misunderstood	negativ
misuse	negativ
mix	negativ
moan	negativ
mobility	positiv
mobilize	positiv
mock	negativ
mockery	negativ
moderate	positiv
moderation	positiv
modernity	positiv
modest	positiv
modesty	positiv
molest	negativ
momentous	positiv
monotonous	negativ
monotony	negativ
monster	negativ
monstrous	negativ
monumental	positiv
moody	negativ
moral	positiv
morale	positiv
moralistic	positiv
morality	positiv
mortify	negativ
motionless	negativ
motivate	positiv
motivated	positiv
motivation	positiv
motive	positiv
motley	negativ
mourn	negativ
mourn	negativ
mourner	negativ
muddle	negativ
muddy	negativ
multitude	positiv
mumble	negativ
mundane	negativ
murder	negativ
murder	negativ
murderous	negativ
murky	negativ
mutter	negativ
mutual	positiv
mutual	positiv
myriad	positiv
myself>	negativ
nag	negativ
naive	negativ
nasty	negativ
natural	positiv
natural	positiv
naughty	negativ
navigable	positiv
neat	positiv
nebulous	negativ
necessarily	positiv
need	negativ
need	negativ
need	negativ
needle	negativ
needy	negativ
negate	negativ
negation	negativ
negative	negativ
neglect	negativ
neglect	negativ
negligence	negativ
negligent	negativ
negotiate	positiv
nervous	negativ
nervousness	negativ
neurotic	negativ
neutralize	negativ
nice	positiv
nice	positiv
nice	positiv
nice	positiv
niche	positiv
nightmare	negativ
nimble	positiv
nix	negativ
nobility	positiv
noble	positiv
nobleman	positiv
noise	negativ
noiseless	positiv
nominate	positiv
non-violence	positiv
non-violent	positiv
nonchalant	negativ
nonsense	negativ
normal	positiv
nosey	negativ
notable	positiv
notoriety	positiv
notorious	negativ
nourish	positiv
nourishment	positiv
novelty	positiv
novice	negativ
nuisance	negativ
nullification	negativ
nullify	negativ
numb	negativ
nurse	positiv
nurture	positiv
nutrient	positiv
nuts	negativ
oasis	positiv
obedience	positiv
obedient	positiv
obey	positiv
object	negativ
objection	negativ
objective	positiv
objective	positiv
oblige	positiv
oblique	negativ
obliterate	negativ
obnoxious	negativ
obscure	negativ
obsolete	negativ
obstacle	negativ
obstinate	negativ
obstruct	negativ
obstruction	negativ
obtain	positiv
obtainable	positiv
odd	negativ
oddity	negativ
offend	negativ
offender	negativ
offensive	negativ
offer	positiv
offer	positiv
offer	positiv
offset	positiv
ominous	negativ
omission	negativ
omit	negativ
onset	positiv
onward	positiv
open	positiv
open	positiv
opinionated	negativ
opponent	negativ
opportune	positiv
opportunity	positiv
oppose	negativ
oppose	negativ
oppose	negativ
opposition	negativ
oppress	negativ
oppression	negativ
oppressive	negativ
optimal	positiv
optimism	positiv
optimistic	positiv
optional	positiv
ordeal	negativ
order	positiv
order	positiv
order	positiv
order	negativ
organize	positiv
organize	positiv
originality	positiv
orphan	negativ
ostracize	negativ
oust	negativ
outbreak	negativ
outburst	negativ
outcast	negativ
outcry	negativ
outgoing	positiv
outlaw	negativ
outlive	positiv
outrage	negativ
outrageous	negativ
outright	positiv
outrun	positiv
outset	positiv
outsider	negativ
outstanding	positiv
outwit	positiv
overbearing	negativ
overcome	positiv
overflow	negativ
overjoyed	positiv
overlook	negativ
overpower	negativ
overrun	negativ
oversight	negativ
overthrow	negativ
overturn	negativ
overwhelming	negativ
overworked	negativ
owe	negativ
pain	negativ
painful	negativ
painstaking	positiv
palatable	positiv
palatial	positiv
paltry	negativ
pamper	positiv
pandemonium	negativ
panic	negativ
paradise	positiv
paralysis	negativ
paralyzed	negativ
paramount	positiv
paranoid	negativ
parasite	negativ
pardon	positiv
pardon	positiv
particular	positiv
particular	negativ
partition	negativ
partner	positiv
partnership	positiv
pass	positiv
pass	negativ
pass	negativ
pass	negativ
passe	negativ
passionate	positiv
pathetic	negativ
patience	positiv
patient	positiv
patient	positiv
patriot	positiv
patriotic	positiv
patron	positiv
patronage	positiv
patronize	negativ
pay	positiv
peace	positiv
peace	positiv
peaceable	positiv
peaceful	positiv
peculiar	negativ
peerless	positiv
perfect	positiv
perfect	positiv
perfect	positiv
perfection	positiv
perfectionism	positiv
perfectionist	positiv
perfume	positiv
peril	negativ
perilous	negativ
perish	negativ
permission	positiv
permit	positiv
perplex	negativ
perplexity	negativ
persecute	negativ
persecution	negativ
perseverance	positiv
persevere	positiv
persuasive	positiv
pertinent	positiv
perturb	negativ
perverse	negativ
pervert	negativ
pessimism	negativ
pessimistic	negativ
pest	negativ
petty	negativ
phobia	negativ
pick	negativ
picturesque	positiv
piece	negativ
piety	positiv
pinch	negativ
pinch	negativ
pinnacle	positiv
pious	positiv
pitiful	negativ
pitiless	negativ
plague	negativ
plague	negativ
plain	positiv
plain	positiv
plain	positiv
plain	positiv
plaintiff	negativ
plausibility	positiv
playful	positiv
playmate	positiv
plaything	positiv
pleasant	positiv
pleasant	positiv
pleasantry	positiv
please	positiv
please	positiv
pleased	positiv
pleased	positiv
pleasurable	positiv
pleasure	positiv
pledge	positiv
plentiful	positiv
plenty	positiv
plight	negativ
plod	negativ
plot	negativ
poetic	positiv
poignant	positiv
point	negativ
pointless	negativ
poise	positiv
poison	negativ
poisonous	negativ
polish	positiv
polite	positiv
politeness	positiv
pollute	negativ
pollution	negativ
pomp	positiv
pompous	negativ
poor	negativ
poor	negativ
poor	negativ
poor	negativ
poor	negativ
poor	negativ
popular	positiv
popularity	positiv
populous	positiv
portable	positiv
positive	positiv
positiveness	positiv
positivity	positiv
posterity	positiv
potency	positiv
potent	positiv
pound	negativ
pout	negativ
poverty	negativ
powerless	negativ
practicable	positiv
practical	positiv
praise	positiv
praise	positiv
prance	positiv
precarious	negativ
precaution	positiv
precedent	positiv
precept	positiv
precious	positiv
precipitate	negativ
precise	positiv
precision	positiv
predicament	negativ
preeminent	positiv
preference	positiv
prejudice	negativ
prejudicial	negativ
premier	positiv
premise	positiv
premium	positiv
preparatory	positiv
preposterous	negativ
press	negativ
prestige	positiv
presumptuous	negativ
pretend	negativ
pretense	negativ
pretentious	negativ
prettily	positiv
pretty	positiv
pretty	positiv
pretty	positiv
pretty	positiv
priceless	positiv
pride	positiv
primarily	positiv
prime	positiv
principal	positiv
principle	positiv
principle	positiv
principle	positiv
prison	negativ
prison	negativ
prisoner	negativ
privacy	positiv
privileged	positiv
privy	positiv
prize	positiv
pro	positiv
proactive	positiv
problem	negativ
procrastinate	negativ
procrastination	negativ
prod	negativ
prodigious	positiv
prodigy	positiv
productive	positiv
productivity	positiv
profess	positiv
proffer	positiv
proficient	positiv
profit	positiv
profit	positiv
profitable	positiv
profound	positiv
progress	positiv
progress	positiv
progressive	positiv
prohibit	negativ
prohibition	negativ
prohibitive	negativ
prolific	positiv
prominence	positiv
prominent	positiv
promise	positiv
promise	positiv
prompt	positiv
prompt	positiv
promptly	positiv
propaganda	negativ
proper	positiv
propitious	positiv
proprietary	positiv
propriety	positiv
prosecute	positiv
prosecution	negativ
prosper	positiv
prosperity	positiv
prosperous	positiv
protect	positiv
protection	positiv
protective	positiv
protector	positiv
protest	negativ
protest	negativ
proud	positiv
provide	positiv
providence	positiv
provocation	negativ
provoke	negativ
prowess	positiv
prowl	negativ
prudence	positiv
prudent	positiv
pry	negativ
punch	negativ
punctual	positiv
punish	negativ
puny	negativ
pure	positiv
purification	positiv
purify	positiv
purity	positiv
purposeful	positiv
purr	positiv
push	negativ
push	negativ
push	negativ
puzzlement	negativ
quaint	positiv
qualify	positiv
qualify	positiv
quality	positiv
qualm	negativ
quandary	negativ
quarrel	negativ
quarrel	negativ
quarrelsome	negativ
queer	negativ
quench	positiv
questionable	negativ
quibble	negativ
quicken	positiv
quit	negativ
quitter	negativ
race	negativ
radiance	positiv
radiant	positiv
radiate	positiv
radical	negativ
rage	negativ
raid	negativ
raise	negativ
rally	positiv
ramble	negativ
rampant	negativ
rapport	positiv
rapt	positiv
rapture	positiv
rascal	negativ
rash	negativ
rat	negativ
ration	negativ
rational	positiv
rattle	negativ
ravage	negativ
rave	positiv
reactionary	negativ
reactive	negativ
readily	positiv
real	positiv
realistic	positiv
realistically	positiv
reap	positiv
reasonable	positiv
reassurance	positiv
reassure	positiv
rebel	negativ
rebel	negativ
rebellion	negativ
rebellious	negativ
rebuff	negativ
rebuke	negativ
rebut	negativ
recalcitrant	negativ
recede	negativ
receptive	positiv
recession	negativ
reckless	negativ
recklessness	negativ
reclaim	positiv
recline	positiv
recoil	negativ
recompense	positiv
reconcile	positiv
reconciliation	positiv
recreation	positiv
redeem	positiv
redemption	positiv
redundancy	negativ
redundant	negativ
reestablish	positiv
refine	positiv
refinement	positiv
refrain	negativ
refuge	positiv
refugee	negativ
refusal	negativ
refuse	negativ
regal	positiv
regard	positiv
regardless	negativ
regress	negativ
regression	negativ
regret	negativ
regret	negativ
regrettable	negativ
rehabilitation	positiv
reinforcement	positiv
reinstate	positiv
reject	negativ
rejection	negativ
rejoice	positiv
relapse	negativ
relaxation	positiv
relevance	positiv
relevancy	positiv
relevant	positiv
reliability	positiv
reliable	positiv
relief	positiv
relieve	positiv
religious	positiv
relish	positiv
reluctant	negativ
remarkable	positiv
remarkably	positiv
remedy	positiv
remodel	positiv
remorse	negativ
renaissance	positiv
renewal	positiv
renounce	negativ
renovate	positiv
renovation	positiv
renown	positiv
renunciation	negativ
repair	positiv
repair	positiv
reparation	positiv
repeal	negativ
repent	positiv
repentance	positiv
repose	positiv
reprehensible	negativ
repress	negativ
reproach	negativ
repudiate	negativ
repugnant	negativ
repulse	negativ
repulsive	negativ
reputable	positiv
rescue	positiv
rescue	positiv
resent	negativ
resentful	negativ
resentment	negativ
resignation	negativ
resolute	positiv
resolve	positiv
resolve	positiv
resolved	positiv
resound	positiv
resourceful	positiv
resourcefulness	positiv
respect	positiv
respect	positiv
respect	positiv
respectable	positiv
respectful	positiv
respite	positiv
resplendent	positiv
responsibility	positiv
responsible	positiv
responsive	positiv
restful	positiv
restless	negativ
restlessness	negativ
restoration	positiv
restore	positiv
restrict	negativ
restrict	negativ
restrict	negativ
restriction	negativ
resurrect	positiv
retaliate	negativ
retard	negativ
retire	negativ
retreat	negativ
retreat	negativ
return	positiv
return	positiv
reunion	positiv
reunite	positiv
revel	positiv
revelation	positiv
revenge	negativ
revere	positiv
reverence	positiv
reverent	positiv
reverently	positiv
revert	negativ
revitalize	positiv
revival	positiv
revive	positiv
revoke	negativ
revolt	negativ
revolution	negativ
reward	positiv
reward	positiv
reward	positiv
rich	positiv
rich	positiv
rich	positiv
rich	positiv
rich	positiv
rich	positiv
riches	positiv
richness	positiv
rid	negativ
ride	negativ
ridicule	negativ
ridicule	negativ
ridiculous	negativ
right	positiv
right	positiv
righteous	positiv
righteousness	positiv
rightful	positiv
rigid	negativ
rigor	negativ
rigorous	negativ
rip	negativ
rip	negativ
ripe	positiv
ripen	positiv
risky	negativ
rival	negativ
rival	negativ
rivalry	negativ
robber	negativ
robbery	negativ
robust	positiv
rogue	negativ
romance	positiv
romantic	positiv
romanticize	positiv
root	negativ
rosy	positiv
rot	negativ
rotten	negativ
rough	negativ
roughness	negativ
round	positiv
roundabout	negativ
rouse	positiv
rubbish	negativ
rude	negativ
rue	negativ
ruffian	negativ
ruin	negativ
ruin	negativ
ruin	negativ
ruin	negativ
ruinous	negativ
rumor	negativ
rumple	negativ
run	negativ
run	negativ
runaway	negativ
rupture	negativ
rupture	negativ
rusty	negativ
ruthless	negativ
ruthlessness	negativ
sabotage	negativ
sacred	positiv
sad	negativ
sadness	negativ
safe	positiv
safe	positiv
safe	positiv
safe	positiv
safeguard	positiv
safety	positiv
sag	negativ
sagacity	positiv
sage	positiv
saint	positiv
salutary	positiv
salutation	positiv
salute	positiv
salvation	positiv
sanctify	positiv
sanctuary	positiv
sane	positiv
sanguine	positiv
sanitary	positiv
sanity	positiv
sank	negativ
sap	negativ
sarcasm	negativ
sarcastic	negativ
satisfaction	positiv
satisfactorily	positiv
satisfactory	positiv
satisfy	positiv
satisfy	positiv
satisfy	positiv
savage	negativ
save	positiv
savings	positiv
savor	positiv
savvy	positiv
scald	negativ
scamper	positiv
scandal	negativ
scandalous	negativ
scapegoat	negativ
scar	negativ
scarcity	negativ
scare	negativ
scare	negativ
scared	negativ
scared	negativ
scary	negativ
scheme	negativ
scheme	negativ
scoff	negativ
scold	negativ
scold	negativ
scorch	negativ
scorn	negativ
scornful	negativ
scoundrel	negativ
scowl	negativ
scrape	negativ
scream	negativ
scream	negativ
screech	negativ
screech	negativ
screw	negativ
scruples	positiv
scrupulous	positiv
scrutinize	negativ
scuffle	negativ
scum	negativ
secede	negativ
secession	negativ
secrecy	negativ
secret	negativ
secure	positiv
secure	positiv
security	positiv
security	positiv
sedentary	negativ
seethe	negativ
segregation	negativ
seize	negativ
selective	positiv
self-contained	positiv
self-respect	positiv
selfish	negativ
selfishness	negativ
semblance	positiv
senile	negativ
sensational	positiv
sense	positiv
sense	positiv
senseless	negativ
sensible	positiv
sensitive	positiv
sensitivity	positiv
sentence	negativ
sequester	negativ
serene	positiv
serious	positiv
seriousness	positiv
serve	negativ
service	negativ
servitude	negativ
settle	positiv
sever	negativ
severe	negativ
severity	negativ
shabby	negativ
shadow	negativ
shady	negativ
shaggy	negativ
shake	negativ
shallow	negativ
shame	negativ
shameful	negativ
shameless	negativ
share	positiv
share	positiv
share	positiv
shark	negativ
shell	negativ
shell	negativ
shelter	positiv
shelter	positiv
shield	positiv
shiny	positiv
shipwreck	negativ
shirk	negativ
shiver	negativ
shock	negativ
shock	negativ
shock	negativ
shock	negativ
shock	negativ
shoddy	negativ
shoot	negativ
shoot	negativ
shoot	negativ
short	negativ
shortage	negativ
shortcoming	negativ
shortsighted	negativ
shot	negativ
shove	negativ
show	negativ
shred	negativ
shrew	negativ
shrewd	positiv
shrewdness	positiv
shriek	negativ
shrill	negativ
shrivel	negativ
shroud	negativ
shrug	negativ
shrug	negativ
shun	negativ
shyness	negativ
sick	negativ
sick	negativ
sick	negativ
sick	negativ
sickly	negativ
sickness	negativ
siege	negativ
significance	positiv
significant	positiv
signify	positiv
silly	negativ
simplicity	positiv
simplify	positiv
simplify	positiv
simplistic	negativ
sin	negativ
sin	negativ
sincere	positiv
sincerity	positiv
sinful	negativ
sinister	negativ
skeptical	negativ
sketchy	negativ
skill	positiv
skill	positiv
skillful	positiv
skirmish	negativ
skulk	negativ
slam	negativ
slander	negativ
slanderer	negativ
slanderous	negativ
slap	negativ
slash	negativ
slaughter	negativ
slayer	negativ
sleazy	negativ
sleek	positiv
sleepless	negativ
slight	negativ
slight	negativ
slight	negativ
slight	negativ
slime	negativ
sloppy	negativ
sloth	negativ
slothful	negativ
slug	negativ
sluggish	negativ
slump	negativ
sly	negativ
smack	negativ
smart	positiv
smart	positiv
smart	positiv
smash	negativ
smash	negativ
smear	negativ
smile	positiv
smile	positiv
smile	positiv
smile	positiv
smitten	positiv
smother	negativ
smuggle	negativ
snare	negativ
snarl	negativ
snatch	negativ
sneak	negativ
sneer	negativ
snore	negativ
sob	negativ
sober	positiv
sociable	positiv
softness	positiv
solace	positiv
solution	positiv
somber	negativ
soothe	positiv
sophisticated	positiv
sore	negativ
soreness	negativ
sorrow	negativ
sorrowful	negativ
sorry	negativ
sorry	negativ
sort	negativ
sought	positiv
sound	positiv
sound	positiv
soundness	positiv
sour	negativ
spank	negativ
spare	positiv
sparkle	positiv
spear	negativ
special	positiv
spectacular	positiv
speedily	positiv
spill	negativ
spinster	negativ
spite	negativ
spiteful	negativ
splendid	positiv
splendor	positiv
split	negativ
spoil	negativ
spot	negativ
spotless	positiv
sprain	negativ
sprightly	positiv
sputter	negativ
squander	negativ
squarely	positiv
stab	negativ
stability	positiv
stabilize	positiv
stable	positiv
stagnant	negativ
stain	negativ
stale	negativ
stalemate	negativ
stammer	negativ
stamp	negativ
stand	positiv
standardize	positiv
standstill	negativ
staple	positiv
stark	negativ
startle	negativ
starvation	negativ
starve	negativ
stately	positiv
static	negativ
statuesque	positiv
staunch	positiv
staunchness	positiv
steadfast	positiv
steadfastness	positiv
steadiness	positiv
steady	positiv
steal	negativ
steal	negativ
stern	negativ
stick	negativ
stifle	negativ
stigma	negativ
stimulate	positiv
stimulation	positiv
sting	negativ
stink	negativ
stole	negativ
stolen	negativ
stolen	negativ
stood	positiv
storm	negativ
stormy	negativ
straggle	negativ
straggler	negativ
straight	positiv
straightforward	positiv
strain	negativ
strain	negativ
strangle	negativ
stray	negativ
stress	negativ
stress	negativ
stricken	negativ
strict	negativ
strict	negativ
strict	negativ
strife	negativ
strike	negativ
strike	negativ
stringent	negativ
struck	negativ
struggle	negativ
struggle	negativ
struggle	negativ
strut	positiv
stubborn	negativ
stubbornly	negativ
stubbornness	negativ
stud	positiv
studious	positiv
study	negativ
stuffy	negativ
stunt	negativ
stupendous	positiv
stupid	negativ
stupid	negativ
stupid	negativ
stupidity	negativ
stupor	negativ
sturdy	positiv
stylish	positiv
suave	positiv
subjection	negativ
subjugate	negativ
subjugation	negativ
sublime	positiv
submissive	negativ
subscribe	positiv
subscription	positiv
subservience	negativ
subside	negativ
subsidize	positiv
subsidy	positiv
subsist	positiv
subsistence	positiv
substantiate	positiv
substitution	negativ
subtle	positiv
subtract	negativ
subversion	negativ
subvert	negativ
succeed	positiv
success	positiv
successful	positiv
succumb	negativ
sucker	negativ
suffer	negativ
suffer	negativ
sufferer	negativ
suffice	positiv
sufficient	positiv
suffocate	negativ
suit	positiv
suit	positiv
suitable	positiv
sullen	negativ
summit	positiv
sumptuous	positiv
sunder	negativ
super	positiv
superficial	negativ
superficiality	negativ
superfluous	negativ
superior	positiv
superiority	positiv
superlative	positiv
superstition	negativ
superstitious	negativ
support	positiv
support	positiv
support	positiv
support	positiv
supportive	positiv
suppress	negativ
suppression	negativ
supreme	positiv
supreme	positiv
surge	positiv
surmise	positiv
surmount	positiv
surpass	positiv
survival	positiv
survive	positiv
survivor	positiv
susceptible	negativ
suspect	negativ
suspect	negativ
suspend	negativ
suspension	negativ
suspicion	negativ
suspicious	negativ
swear	negativ
sweet	positiv
sweet	positiv
sweet	positiv
sweet	positiv
sweeten	positiv
sweetheart	positiv
sweetness	positiv
swiftness	positiv
swoon	positiv
swore	negativ
sworn	positiv
symbolize	positiv
symmetry	positiv
sympathetic	positiv
sympathize	positiv
sympathy	positiv
symptom	negativ
synthesis	positiv
taboo	negativ
tact	positiv
tactics	positiv
taint	negativ
talent	positiv
talented	positiv
tamper	negativ
tantrum	negativ
tardy	negativ
tariff	negativ
taste	positiv
tatter	negativ
taunt	negativ
taunt	negativ
tax	negativ
tear	negativ
tear	negativ
tease	negativ
tedious	negativ
temper	negativ
temper	negativ
temperance	positiv
temperate	positiv
tempest	negativ
temporarily	negativ
tempt	positiv
temptation	negativ
tenacious	positiv
tenacity	positiv
tenderness	positiv
tense	negativ
tension	negativ
terrible	negativ
terrific	positiv
terrify	negativ
terror	negativ
terrorism	negativ
terrorize	negativ
thank	positiv
thank	positiv
thank	positiv
thankful	positiv
theft	negativ
therapeutic	positiv
thief	negativ
thirst	negativ
thirsty	negativ
thorny	negativ
thorough	positiv
thoughtful	positiv
thoughtfulness	positiv
thoughtless	negativ
thrash	negativ
threat	negativ
threaten	negativ
thrift	positiv
thrifty	positiv
thrill	positiv
thrive	positiv
throw	negativ
throw	negativ
thud	negativ
thwart	negativ
timidity	negativ
tingle	positiv
tire	negativ
tire	negativ
tire	negativ
tired	negativ
tired	negativ
tired	negativ
tired	negativ
tiresome	negativ
togetherness	positiv
toil	negativ
tolerable	negativ
tolerance	positiv
tolerant	positiv
tolerate	positiv
toleration	positiv
too	negativ
topmost	positiv
topple	negativ
torment	negativ
torrent	negativ
torturous	negativ
touchy	negativ
tradition	positiv
traditional	positiv
tragedy	negativ
tragic	negativ
train	positiv
traitor	negativ
tramp	negativ
trample	negativ
tranquil	positiv
tranquility	positiv
transgress	negativ
trap	negativ
trap	negativ
trauma	negativ
traumatic	negativ
travel	positiv
treacherous	negativ
treachery	negativ
treason	negativ
treasonous	negativ
treasure	positiv
treasure	positiv
treat	positiv
treatise	positiv
treaty	positiv
tremendous	positiv
tremendous	positiv
trespass	negativ
tribute	positiv
trick	negativ
trick	negativ
triumph	positiv
triumph	positiv
triumphal	positiv
triumphant	positiv
trivial	negativ
trophy	positiv
trouble	negativ
trouble	negativ
trouble	negativ
trouble	negativ
troublesome	negativ
truant	negativ
trudge	negativ
true	positiv
true	positiv
true	positiv
true	positiv
true	positiv
trust	positiv
trust	positiv
trust	positiv
trust	positiv
trust	positiv
trust	positiv
trustworthiness	positiv
trustworthy	positiv
truth	positiv
truthful	positiv
try	negativ
try	negativ
turbulent	negativ
turmoil	negativ
turn	negativ
turn	negativ
twitch	negativ
tyranny	negativ
ugly	negativ
ultimatum	negativ
unaccustomed	negativ
unarm	negativ
unattractive	negativ
unauthentic	negativ
unavoidable	negativ
unbearable	negativ
unbelievable	negativ
unbound	positiv
unbroken	positiv
uncivil	negativ
unclean	negativ
unclear	negativ
uncomfortable	negativ
uncommon	positiv
uncouth	negativ
undependability	negativ
undependable	negativ
undermine	negativ
understand	positiv
understand	positiv
understandable	positiv
understood	positiv
underworld	negativ
undesirable	negativ
undid	negativ
undignified	negativ
undo	negativ
undone	negativ
undoubted	positiv
undoubtedly	positiv
undue	negativ
uneasiness	negativ
uneasy	negativ
uneconomical	negativ
unemployed	negativ
unequal	negativ
uneven	negativ
unexpectedly	negativ
unfair	negativ
unfaithful	negativ
unfamiliar	negativ
unfavorable	negativ
unfeeling	negativ
unfit	negativ
unforeseen	negativ
unforgettable	positiv
unfortunate	negativ
unfortunate	negativ
unfortunate	negativ
unfriendly	negativ
ungrateful	negativ
unguarded	negativ
unhappiness	negativ
unhappy	negativ
unhealthy	negativ
unhurried	positiv
unimpeachable	positiv
unimportant	negativ
uninformed	negativ
unique	positiv
unity	positiv
unjust	negativ
unjustified	negativ
unkind	negativ
unlawful	negativ
unlimited	positiv
unlucky	negativ
unmoved	negativ
unnatural	negativ
unnecessary	negativ
unnerve	negativ
unnoticed	negativ
unobserved	negativ
unpleasant	negativ
unpopular	negativ
unprofitable	negativ
unqualified	negativ
unreasonable	negativ
unreliability	negativ
unreliable	negativ
unrest	negativ
unruly	negativ
unsafe	negativ
unsatisfactory	negativ
unscrupulous	negativ
unseen	negativ
unselfish	positiv
unsettling	negativ
unsound	negativ
unspeakable	negativ
unstable	negativ
unsteadiness	negativ
unsteady	negativ
unsuccessful	negativ
untimely	negativ
untouched	positiv
untrained	negativ
untrue	negativ
untrustworthy	negativ
untruth	negativ
unwilling	negativ
unwillingness	negativ
unwise	negativ
unworthy	negativ
upbeat	positiv
upfront	positiv
upgrade	positiv
upheaval	negativ
upheld	positiv
uphold	positiv
uplift	positiv
uppermost	positiv
upright	positiv
uprising	negativ
uproar	negativ
uproot	negativ
upset	negativ
upset	negativ
upset	negativ
upset	negativ
upset	negativ
upside	positiv
upward	positiv
usable	positiv
useful	positiv
usefulness	positiv
useless	negativ
usurp	negativ
utilitarian	positiv
utilization	positiv
utilize	positiv
utterance	negativ
uttermost	positiv
vagabond	negativ
vagrant	negativ
vague	negativ
vagueness	negativ
vain	negativ
valiant	positiv
valid	positiv
validity	positiv
valor	positiv
valuable	positiv
value	positiv
value	positiv
vanish	negativ
vanity	negativ
vanquish	positiv
vastness	positiv
vehement	negativ
venerable	positiv
venerate	positiv
vengeance	negativ
venom	negativ
venomous	negativ
verification	positiv
verify	positiv
veritable	positiv
versatile	positiv
versatility	positiv
veto	negativ
vex	negativ
vexation	negativ
vexing	negativ
viability	positiv
viable	positiv
vice	negativ
vicious	negativ
victorious	positiv
vie	negativ
vigilance	positiv
vigilant	positiv
vile	negativ
villain	negativ
violate	negativ
violation	negativ
violence	negativ
violent	negativ
viper	negativ
virtue	positiv
virtuous	positiv
visionary	positiv
visualization	positiv
vitality	positiv
vivacious	positiv
vivid	positiv
void	negativ
volatile	negativ
volatility	negativ
voluntary	positiv
vomit	negativ
vouchsafe	positiv
vulgar	negativ
wail	negativ
wait	negativ
wallow	negativ
wane	negativ
wanton	negativ
war	negativ
warfare	negativ
warlike	negativ
warm	positiv
warm	positiv
warm	positiv
warm	positiv
warm	positiv
warmhearted	positiv
warmth	positiv
warp	negativ
wary	negativ
waste	negativ
waste	negativ
wasteful	negativ
wastefulness	negativ
wayward	negativ
weaken	negativ
wear	negativ
weariness	negativ
wearisome	negativ
wee	negativ
weed	negativ
weep	negativ
weird	negativ
welcome	positiv
welcome	positiv
welcome	positiv
welcome	positiv
welfare	positiv
well	positiv
well	positiv
wench	negativ
whack	negativ
whimper	negativ
whimsical	positiv
whine	negativ
whip	negativ
whip	negativ
whip	negativ
wholesome	positiv
wicked	negativ
wickedness	negativ
wild	negativ
wild	negativ
wild	negativ
wild	negativ
willful	positiv
willing	positiv
willingness	positiv
wilt	negativ
wily	negativ
wince	negativ
wisdom	positiv
wise	positiv
wise	positiv
wise	positiv
wise	positiv
wise	positiv
witchcraft	negativ
withheld	negativ
withhold	negativ
witty	positiv
woe	negativ
woeful	negativ
wonder	positiv
wonderful	positiv
wondrous	positiv
woo	positiv
workable	positiv
workmanship	positiv
world-famous	positiv
worn	negativ
worn	negativ
worrier	negativ
worry	negativ
worry	negativ
worry	negativ
worry	negativ
worry	negativ
worse	negativ
worsen	negativ
worst	negativ
worth	positiv
worth	positiv
worth	positiv
worth	positiv
worth-while	positiv
worthiness	positiv
worthless	negativ
worthy	positiv
wound	negativ
wound	negativ
wound	negativ
wrath	negativ
wreck	negativ
wrestle	negativ
wretch	negativ
wretchedness	negativ
wrinkle	negativ
writhe	negativ
wrong	negativ
wrong	negativ
wrongful	negativ
wrought	negativ
yawn	negativ
yearn	negativ
yelp	negativ
zenith	positiv
zest	positiv
